XRRXX
XXXBX
XXRXX
GXXXX
XXGXX
XXXBX
XXGXG
XBXXX
XXRBX