XrRXX
XXXbX
XXRXX
gX+XX
XXgXX
*XXbX
XXGXg
XgX-X
XXRBX